"admin2Pcod","mesas_informadas","mesas_instaladas","personas_habilitadas","votos_validos","votos_no_marcados","votos_nulos","votos_si","votos_no"
"CO91001",82,82,34592,8866,40,84,4403,4463
"CO91263",2,2,743,221,0,2,170,51
"CO91405",3,3,1030,362,1,3,300,62
"CO91407",3,3,1008,214,1,1,189,25
"CO91430",1,1,18,5,0,0,4,1
"CO91460",2,2,477,96,0,0,89,7
"CO91530",1,1,259,57,1,1,52,5
"CO91536",1,1,405,119,0,0,97,22
"CO91540",10,10,4317,1104,32,17,830,274
"CO91669",2,2,642,141,0,2,125,16
"CO91798",3,3,1304,333,7,4,265,68
"CO05001",3346,3346,1508418,684721,3309,6754,253548,431173
"CO05002",39,39,15274,3401,194,52,1296,2105
"CO05004",6,6,1938,545,14,13,213,332
"CO05021",11,11,4577,1662,51,22,966,696
"CO05030",53,53,22028,6223,53,94,2084,4139
"CO05031",40,40,16928,3614,132,72,1310,2304
"CO05034",76,76,34842,8922,78,93,3193,5729
"CO05036",14,14,5679,1557,9,23,553,1004
"CO05038",23,23,9154,1794,57,84,705,1089
"CO05040",30,30,11144,2717,227,40,1764,953
"CO05042",48,48,19732,5341,52,102,2041,3300
"CO05044",14,14,5715,1103,31,16,363,740
"CO05045",201,201,89196,27131,352,478,14195,12936
"CO05051",52,52,21448,5628,181,57,3691,1937
"CO05055",19,19,6627,2001,41,23,650,1351
"CO05059",12,12,4844,977,23,26,301,676
"CO05079",92,92,38541,12866,287,277,4200,8666
"CO05086",14,14,4807,1584,16,17,687,897
"CO05088",679,679,318411,119764,509,1577,43642,76122
"CO05091",19,19,8372,1576,11,22,466,1110
"CO05093",33,33,13377,2924,50,49,1005,1919
"CO05101",60,60,24029,5519,57,60,1644,3875
"CO05107",19,19,6169,1971,62,45,1367,604
"CO05113",19,19,6829,1364,22,20,474,890
"CO05120",48,48,19788,3864,57,83,2506,1358
"CO05125",15,15,6091,1514,43,43,593,921
"CO05129",129,129,60580,25441,123,397,9292,16149
"CO05134",15,15,6360,1223,32,41,619,604
"CO05138",33,33,13402,4650,113,121,1911,2739
"CO05142",14,14,4856,1171,16,12,578,593
"CO05145",14,14,5231,1358,33,26,568,790
"CO05147",98,98,41461,11384,159,190,5327,6057
"CO05148",80,80,33070,16315,163,272,5528,10787
"CO05150",11,11,4081,1105,22,23,464,641
"CO05154",162,162,66133,20296,247,368,8801,11495
"CO05172",89,89,44791,12067,138,187,6322,5745
"CO05190",26,26,11434,2921,33,63,1084,1837
"CO05197",34,34,12965,4653,130,81,1647,3006
"CO05206",10,10,4409,1503,23,27,572,931
"CO05209",38,38,16027,3079,55,50,998,2081
"CO05212",127,127,62062,24587,323,369,9535,15052
"CO05234",41,41,16986,4593,166,99,2971,1622
"CO05237",39,39,16576,5269,41,71,1371,3898
"CO05240",29,29,11421,2755,59,32,967,1788
"CO05250",85,85,36056,7223,141,156,3167,4056
"CO05264",18,18,7957,2634,16,30,868,1766
"CO05266",507,507,232003,105055,872,1061,37800,67255
"CO05282",46,46,18196,4767,27,64,1703,3064
"CO05284",46,46,16785,3892,68,78,2148,1744
"CO05306",10,10,3946,1223,11,17,666,557
"CO05308",111,111,47612,16768,90,277,6088,10680
"CO05310",20,20,8404,2100,31,61,772,1328
"CO05313",24,24,10270,3502,75,53,1382,2120
"CO05315",16,16,5656,1301,40,47,714,587
"CO05318",77,77,31687,14474,116,214,3870,10604
"CO05321",15,15,6523,3198,26,37,1232,1966
"CO05347",16,16,6157,1427,36,29,632,795
"CO05353",13,13,5219,1113,18,11,459,654
"CO05360",527,527,245703,94793,426,1344,35166,59627
"CO05361",48,49,17406,3902,139,116,2706,1196
"CO05364",28,28,12094,4504,46,44,1620,2884
"CO05368",27,27,11023,3298,36,39,957,2341
"CO05376",97,97,44306,22304,171,325,6715,15589
"CO05380",108,108,50695,18441,88,194,6725,11716
"CO05390",15,15,6588,2406,22,31,1017,1389
"CO05400",38,38,16219,7333,60,136,2551,4782
"CO05411",24,24,9204,2607,56,40,933,1674
"CO05425",19,19,7467,1842,31,26,777,1065
"CO05440",76,76,38176,17474,103,190,5481,11993
"CO05467",15,15,6043,1729,63,35,953,776
"CO05475",9,9,2724,1117,19,14,1073,44
"CO05480",33,33,13626,2862,119,49,1846,1016
"CO05483",25,25,9015,2412,70,31,786,1626
"CO05490",76,76,32486,7219,101,155,4359,2860
"CO05495",44,44,18186,3736,41,57,1937,1799
"CO05501",7,7,2719,722,11,7,273,449
"CO05541",36,36,15806,5297,63,55,2032,3265
"CO05543",18,18,6089,2240,48,43,1632,608
"CO05576",17,17,7113,1731,32,24,593,1138
"CO05579",84,84,34085,8826,86,116,2780,6046
"CO05585",31,31,12202,3881,38,55,2281,1600
"CO05591",32,32,12982,3830,30,42,1007,2823
"CO05604",40,40,17020,3415,38,126,1186,2229
"CO05607",35,35,15100,6848,45,58,2145,4703
"CO05615",214,214,94806,46957,197,637,14361,32596
"CO05628",18,18,7052,2279,44,41,778,1501
"CO05631",125,125,59616,26858,39,285,9955,16903
"CO05642",33,33,13483,2403,47,24,782,1621
"CO05647",16,16,5184,1570,66,65,706,864
"CO05649",34,34,13944,5087,60,95,2390,2697
"CO05652",14,14,6140,1561,50,26,660,901
"CO05656",29,29,11911,3395,39,41,1260,2135
"CO05658",8,8,3164,984,25,23,363,621
"CO05659",42,42,17433,4042,43,33,2677,1365
"CO05660",28,28,10748,3571,37,36,890,2681
"CO05664",45,45,18915,7175,50,106,1841,5334
"CO05665",61,61,25244,4042,42,62,2060,1982
"CO05667",29,29,12155,3752,51,258,1457,2295
"CO05670",35,35,14580,4334,53,79,1786,2548
"CO05674",42,42,16445,5880,67,80,1642,4238
"CO05679",51,51,22078,5889,67,107,2101,3788
"CO05686",64,64,25810,9911,90,279,2984,6927
"CO05690",24,24,9178,2766,56,107,1085,1681
"CO05697",62,62,26217,12349,122,150,3329,9020
"CO05736",62,62,26169,4589,27,68,1516,3073
"CO05756",77,77,27198,8869,158,266,2319,6550
"CO05761",30,30,12063,4141,58,60,1875,2266
"CO05789",35,35,14473,4468,59,52,1579,2889
"CO05790",62,62,26186,5788,90,110,3477,2311
"CO05792",14,14,5883,1194,22,14,503,691
"CO05809",22,22,8726,2104,37,39,742,1362
"CO05819",11,11,4383,1305,61,63,798,507
"CO05837",196,196,84866,20265,277,371,11378,8887
"CO05842",16,16,6351,1764,24,37,951,813
"CO05847",55,55,22361,5603,123,138,2644,2959
"CO05854",29,29,12054,2141,63,57,1072,1069
"CO05856",15,15,5665,1490,22,22,597,893
"CO05858",24,24,10165,1771,44,22,503,1268
"CO05861",28,28,10977,2864,26,26,1097,1767
"CO05873",17,17,5245,2165,9,13,2079,86
"CO05885",14,14,6006,1129,25,6,437,692
"CO05887",74,74,33092,9032,264,187,2941,6091
"CO05890",39,39,15878,3399,56,57,1344,2055
"CO05893",31,31,12182,5186,62,128,2376,2810
"CO05895",44,44,18939,3398,59,88,1672,1726
"CO81001",156,156,67929,23350,139,447,8159,15191
"CO81065",65,65,27274,9729,150,234,7440,2289
"CO81220",9,9,3564,1054,11,38,424,630
"CO81300",26,26,10912,3401,58,187,2338,1063
"CO81591",14,14,3637,1094,18,19,428,666
"CO81736",73,73,31702,9625,131,335,4457,5168
"CO81794",80,80,31607,10674,131,263,5407,5267
"CO08001",2350,2350,1029268,254217,1047,1111,146039,108178
"CO08078",108,108,45824,12352,139,58,8936,3416
"CO08137",45,45,19302,2785,13,14,1728,1057
"CO08141",27,27,11294,2984,25,25,2078,906
"CO08296",82,82,34607,8362,28,74,5186,3176
"CO08372",41,41,17179,3471,10,19,2389,1082
"CO08421",56,56,23080,3511,28,25,2265,1246
"CO08433",164,164,74964,15718,45,94,8810,6908
"CO08436",31,31,13416,1977,8,10,1660,317
"CO08520",45,45,19636,3988,255,22,2871,1117
"CO08549",14,14,5409,1509,13,15,1118,391
"CO08558",29,29,12246,3385,23,29,2746,639
"CO08560",42,42,17776,3866,23,20,2445,1421
"CO08573",74,74,31487,9266,26,38,5701,3565
"CO08606",44,44,18423,4154,35,24,3325,829
"CO08634",54,54,22784,5086,17,29,3251,1835
"CO08638",151,151,64908,17514,421,142,12851,4663
"CO08675",24,24,9928,1948,3,18,1467,481
"CO08685",62,62,25858,5702,17,24,4088,1614
"CO08758",606,606,264289,57252,226,307,33765,23487
"CO08770",22,22,9555,2422,3,3,1837,585
"CO08832",24,24,9481,2786,17,16,1888,898
"CO08849",17,17,7497,2166,14,15,1677,489
"CO11001",12078,12078,5547172,2538545,6601,25213,1423612,1114933
"CO13001",1654,1654,732774,146235,688,518,81500,64735
"CO13006",44,44,15748,6181,61,87,4307,1874
"CO13030",18,18,6667,1387,22,15,786,601
"CO13042",14,14,5625,1919,8,23,1690,229
"CO13052",113,113,51077,9672,50,63,6030,3642
"CO13062",21,21,7362,1481,28,7,1118,363
"CO13074",30,30,11068,2749,59,22,1465,1284
"CO13140",44,44,17670,3630,48,37,2140,1490
"CO13160",15,15,6076,2610,17,44,1878,732
"CO13188",24,24,9346,2938,29,21,2082,856
"CO13212",35,35,13053,4613,66,43,3612,1001
"CO13222",24,24,10304,1736,19,17,1146,590
"CO13244",129,129,53418,15577,129,216,8287,7290
"CO13248",19,19,7284,1983,23,11,1578,405
"CO13268",17,17,5820,1485,19,15,911,574
"CO13300",26,26,9848,2607,16,25,1322,1285
"CO13430",227,227,93554,26444,206,261,16478,9966
"CO13433",48,48,19421,4041,48,32,2819,1222
"CO13440",26,26,8814,2280,33,13,1361,919
"CO13442",92,92,37800,8770,97,73,7009,1761
"CO13458",25,25,8357,2047,35,17,1652,395
"CO13468",92,92,34934,8234,59,68,5198,3036
"CO13473",29,29,10842,4142,34,39,1936,2206
"CO13549",50,50,16205,4858,49,41,2973,1885
"CO13580",13,13,4492,1415,4,18,1092,323
"CO13600",26,26,9573,3273,29,44,2457,816
"CO13620",16,16,6462,1879,6,8,1630,249
"CO13647",33,33,14001,2769,16,19,1900,869
"CO13650",25,25,7937,2377,17,15,1949,428
"CO13654",51,51,20212,6213,73,62,3736,2477
"CO13655",19,19,6809,2001,20,18,1389,612
"CO13657",72,72,30146,8421,86,111,5134,3287
"CO13667",27,27,10724,2799,20,22,1943,856
"CO13670",45,45,17280,5742,122,94,2802,2940
"CO13673",29,29,11565,2312,17,119,1759,553
"CO13683",30,30,13161,1738,9,24,1129,609
"CO13688",50,50,19146,7069,57,112,2648,4421
"CO13744",35,35,11953,3536,43,73,1753,1783
"CO13760",18,18,7990,2212,10,20,1888,324
"CO13780",24,24,8861,2915,37,16,1870,1045
"CO13810",35,35,12563,3052,34,22,1686,1366
"CO13836",125,125,58808,9884,29,41,5927,3957
"CO13838",32,32,13769,2509,17,17,1728,781
"CO13873",35,35,15014,1944,16,14,1181,763
"CO13894",21,21,8695,3647,34,46,3140,507
"CO15001",258,258,116576,57892,143,1003,32780,25112
"CO15022",5,5,1908,675,7,11,348,327
"CO15047",36,36,12347,4193,41,65,1208,2985
"CO15051",11,11,4570,1655,9,54,773,882
"CO15087",16,16,6748,2494,27,81,1150,1344
"CO15090",4,4,1465,568,5,15,387,181
"CO15092",5,5,1915,659,7,19,407,252
"CO15097",14,14,5162,1800,26,40,798,1002
"CO15104",10,10,4201,1033,16,24,601,432
"CO15106",5,5,2098,753,12,7,471,282
"CO15109",13,13,4573,1406,25,29,616,790
"CO15114",2,2,794,357,6,7,174,183
"CO15131",9,9,3278,1104,11,24,651,453
"CO15135",7,7,2508,939,15,23,507,432
"CO15162",8,8,3482,1556,18,54,961,595
"CO15172",8,8,3131,918,7,17,421,497
"CO15176",98,98,40893,16729,87,303,8110,8619
"CO15180",10,10,3519,1330,35,40,672,658
"CO15183",19,19,6331,2155,89,75,861,1294
"CO15185",14,14,5445,1606,29,19,644,962
"CO15187",6,6,2542,916,7,7,477,439
"CO15189",9,9,3872,1198,19,16,543,655
"CO15204",22,22,8585,3533,34,86,2081,1452
"CO15212",10,10,3278,1300,13,19,779,521
"CO15215",6,6,2228,919,14,22,408,511
"CO15218",9,9,3133,1020,44,16,394,626
"CO15223",16,16,5484,1378,23,68,781,597
"CO15224",8,8,3186,1226,8,30,683,543
"CO15226",5,5,1851,632,2,19,269,363
"CO15232",10,10,4330,867,18,27,537,330
"CO15236",5,5,1769,638,10,8,260,378
"CO15238",189,189,83354,40322,119,770,19535,20787
"CO15244",10,10,3716,1204,30,48,374,830
"CO15248",6,6,2301,966,11,20,339,627
"CO15272",14,14,5680,2075,17,37,1317,758
"CO15276",7,7,3078,1326,8,20,527,799
"CO15293",7,7,3020,1299,19,24,621,678
"CO15296",10,10,4056,1446,22,23,621,825
"CO15299",29,29,11845,5019,36,119,2534,2485
"CO15317",4,4,1656,601,11,19,122,479
"CO15322",22,22,8954,3317,24,80,1718,1599
"CO15325",9,9,3849,1494,14,22,861,633
"CO15332",10,10,3033,1148,14,42,556,592
"CO15362",6,6,2224,832,12,13,367,465
"CO15367",13,13,5464,1615,25,33,1031,584
"CO15368",9,9,3218,929,22,23,359,570
"CO15377",7,7,2722,973,13,17,444,529
"CO15380",6,6,2576,1018,26,28,525,493
"CO15401",5,5,1513,553,11,9,417,136
"CO15403",8,8,2537,898,16,19,287,611
"CO15407",24,24,10171,4786,25,66,2479,2307
"CO15425",9,9,3603,1192,19,24,464,728
"CO15442",17,17,6271,1830,16,25,1371,459
"CO15455",18,18,7568,3563,44,81,2330,1233
"CO15464",10,10,4003,1655,6,25,397,1258
"CO15466",9,9,3643,1400,5,29,530,870
"CO15469",42,42,17452,6273,57,162,3257,3016
"CO15476",12,12,4938,1791,14,41,955,836
"CO15480",17,17,7195,2328,37,55,858,1470
"CO15491",27,27,11546,5644,11,86,2835,2809
"CO15494",11,11,4608,1731,17,46,1107,624
"CO15500",6,6,2392,1097,8,30,605,492
"CO15507",22,22,6406,2318,23,28,1021,1297
"CO15511",5,5,2001,744,20,15,370,374
"CO15514",7,7,2338,1171,14,43,558,613
"CO15516",59,59,24543,11053,59,200,6187,4866
"CO15518",5,5,1713,633,8,9,234,399
"CO15522",4,4,1605,620,14,15,285,335
"CO15531",17,17,6712,2323,37,41,1521,802
"CO15533",5,5,1406,703,8,26,320,383
"CO15537",11,11,4373,1685,18,38,1119,566
"CO15542",16,16,6418,1771,15,33,710,1061
"CO15550",3,3,1021,451,9,3,195,256
"CO15572",88,88,35230,13881,127,339,4270,9611
"CO15580",15,15,4928,1703,33,32,637,1066
"CO15599",21,21,8601,2733,22,34,1466,1267
"CO15600",12,12,4570,1666,20,44,815,851
"CO15621",7,7,2283,895,17,17,469,426
"CO15632",24,24,9555,3496,56,112,2246,1250
"CO15638",8,8,3320,1326,11,13,702,624
"CO15646",31,31,13405,4683,36,130,2343,2340
"CO15660",4,4,1463,679,10,22,434,245
"CO15664",14,14,5295,1790,28,20,946,844
"CO15667",14,14,4488,1739,18,22,628,1111
"CO15673",9,9,3636,1088,29,30,368,720
"CO15676",7,7,2760,1063,17,21,513,550
"CO15681",16,16,5810,1830,31,29,584,1246
"CO15686",16,16,6831,2140,24,34,1106,1034
"CO15690",9,9,3309,1089,18,30,433,656
"CO15693",20,20,8045,3626,28,72,1553,2073
"CO15696",7,7,3068,1047,16,21,648,399
"CO15720",7,7,2398,735,15,23,373,362
"CO15723",3,3,1227,371,2,4,197,174
"CO15740",15,15,6256,2231,25,54,778,1453
"CO15753",17,17,7449,3450,37,56,1461,1989
"CO15755",17,17,5922,2005,39,60,791,1214
"CO15757",16,16,6151,2298,33,64,1138,1160
"CO15759",198,198,89443,41126,148,700,20261,20865
"CO15761",7,7,2779,873,8,14,529,344
"CO15762",6,6,2528,1145,152,22,686,459
"CO15763",13,13,5413,2017,14,39,1039,978
"CO15764",12,12,5229,2229,20,24,740,1489
"CO15774",8,8,2580,1111,19,36,701,410
"CO15776",12,12,5264,2063,18,38,1132,931
"CO15778",9,9,3682,1274,14,30,612,662
"CO15790",12,12,4986,1554,7,37,913,641
"CO15798",9,9,3555,1620,17,26,1028,592
"CO15804",19,19,7402,2052,14,57,1312,740
"CO15806",19,19,8412,3527,13,75,1842,1685
"CO15808",6,6,2538,1137,5,20,632,505
"CO15810",9,9,3353,1077,30,29,557,520
"CO15814",16,16,6996,2275,29,40,1107,1168
"CO15816",10,10,4284,926,19,22,516,410
"CO15820",8,8,2924,1341,10,19,552,789
"CO15822",11,11,4105,908,10,25,318,590
"CO15832",3,3,1314,642,4,9,461,181
"CO15835",13,13,5703,1729,16,41,1161,568
"CO15837",18,18,7216,3033,23,57,1536,1497
"CO15839",5,5,1841,904,16,29,492,412
"CO15842",14,14,5815,2204,30,47,980,1224
"CO15861",25,25,10912,3255,18,81,1566,1689
"CO15879",6,6,2553,795,11,16,343,452
"CO15897",9,9,3874,1383,12,15,910,473
"CO17001",738,738,323102,151101,734,2505,74140,76961
"CO17013",47,47,18854,6727,134,174,1961,4766
"CO17042",72,72,27896,10786,153,270,3356,7430
"CO17050",30,30,11540,3982,86,123,1573,2409
"CO17088",27,27,10118,3619,219,52,1514,2105
"CO17174",92,92,43763,16728,162,315,6185,10543
"CO17272",24,24,9343,3148,71,62,1365,1783
"CO17380",131,131,57740,20466,122,545,6908,13558
"CO17388",17,17,5641,1974,43,50,866,1108
"CO17433",41,41,15465,4919,82,91,1773,3146
"CO17442",18,18,6840,1647,23,41,514,1133
"CO17444",28,28,11445,3879,101,93,1452,2427
"CO17446",8,8,2658,778,21,32,387,391
"CO17486",44,44,19307,6474,101,168,2283,4191
"CO17495",14,14,5865,2085,36,51,906,1179
"CO17513",32,32,12064,4275,62,76,1548,2727
"CO17524",35,35,14755,4380,34,51,1867,2513
"CO17541",43,43,16734,5839,198,191,1880,3959
"CO17614",90,90,37633,14472,205,399,6070,8402
"CO17616",27,27,10761,2980,35,49,959,2021
"CO17653",38,38,15660,5117,173,86,2096,3021
"CO17662",42,42,16191,6327,156,209,2814,3513
"CO17665",12,12,4918,1440,21,30,623,817
"CO17777",49,49,21254,7393,141,349,2408,4985
"CO17867",21,21,8262,2984,44,51,1249,1735
"CO17873",84,84,37945,17276,130,330,7470,9806
"CO17877",33,33,12839,5110,38,56,1373,3737
"CO18001",263,263,115892,38396,187,421,14803,23593
"CO18029",9,9,3923,1287,121,22,445,842
"CO18094",18,18,7573,2505,36,59,1001,1504
"CO18150",43,43,18805,4786,60,81,3530,1256
"CO18205",19,19,7604,1781,35,55,729,1052
"CO18247",38,38,15558,4104,37,89,1593,2511
"CO18256",28,28,11865,2596,35,52,1157,1439
"CO18410",26,26,10500,3092,21,23,2295,797
"CO18460",17,17,6861,1340,9,20,750,590
"CO18479",9,9,3584,1118,9,16,387,731
"CO18592",45,45,18802,5288,78,104,2643,2645
"CO18610",24,24,8875,2815,24,55,1116,1699
"CO18753",80,80,31524,9588,87,111,6034,3554
"CO18756",21,21,7754,1966,18,20,1506,460
"CO18785",13,13,5746,1288,18,26,484,804
"CO18860",15,15,6188,1529,22,60,724,805
"CO85001",242,242,102568,51064,229,858,14561,36503
"CO85010",67,67,26606,13789,96,599,4123,9666
"CO85015",4,4,1551,934,9,25,663,271
"CO85125",28,28,6995,2724,40,61,591,2133
"CO85136",2,2,762,442,5,11,391,51
"CO85139",30,30,10075,4724,40,86,1459,3265
"CO85162",29,29,11103,5637,38,87,1639,3998
"CO85225",23,23,6023,2851,41,67,579,2272
"CO85230",22,22,7605,2982,30,61,1182,1800
"CO85250",56,56,23027,9622,100,210,2243,7379
"CO85263",16,16,6622,3346,34,91,662,2684
"CO85279",5,5,1260,642,20,43,337,305
"CO85300",7,7,2758,1344,13,30,680,664
"CO85315",4,4,1537,660,14,77,563,97
"CO85325",18,18,5886,2536,28,52,548,1988
"CO85400",13,13,4325,1878,45,42,528,1350
"CO85410",38,38,15751,8246,60,139,2209,6037
"CO85430",28,28,9211,3701,42,87,735,2966
"CO85440",45,45,19519,8050,59,173,2425,5625
"CO19001",511,511,225161,93924,525,1229,55296,38628
"CO19022",33,33,12511,3444,85,169,2874,570
"CO19050",49,49,17783,6558,97,175,5807,751
"CO19075",41,41,15693,5156,107,126,4425,731
"CO19100",111,111,31054,8006,163,286,5234,2772
"CO19110",42,42,15556,6367,143,188,4594,1773
"CO19130",58,58,23310,6924,168,138,4922,2002
"CO19137",51,51,20628,8507,169,267,6792,1715
"CO19142",84,84,29946,13881,135,368,10035,3846
"CO19212",44,44,17445,8189,113,187,5669,2520
"CO19256",109,109,34429,11211,368,359,6595,4616
"CO19290",11,11,4576,2050,37,64,1530,520
"CO19318",57,57,19182,6011,83,78,5596,415
"CO19355",46,46,16634,4495,80,74,3318,1177
"CO19364",21,21,8072,3790,66,89,3270,520
"CO19392",22,22,8829,2823,69,63,1714,1109
"CO19397",44,44,15137,4961,175,128,3840,1121
"CO19418",47,47,12401,4245,25,12,3980,265
"CO19450",41,41,13882,4095,99,77,3135,960
"CO19455",49,49,18593,9312,58,166,5933,3379
"CO19473",49,49,18642,6176,211,225,3764,2412
"CO19513",18,18,6631,3010,35,104,2258,752
"CO19517",56,56,19497,6493,240,154,4692,1801
"CO19532",71,71,25540,8003,108,112,5770,2233
"CO19533",18,18,5010,1488,29,31,996,492
"CO19548",71,71,26554,9080,153,149,4840,4240
"CO19573",70,70,32002,12605,124,334,8482,4123
"CO19585",21,21,8676,2280,52,54,1458,822
"CO19622",22,22,8645,3005,83,90,1794,1211
"CO19693",19,19,7156,2521,93,70,1991,530
"CO19698",162,162,73826,28947,210,569,16723,12224
"CO19701",16,16,4092,1208,28,32,787,421
"CO19743",61,61,21970,7596,191,193,5792,1804
"CO19760",23,23,7302,2937,123,83,2010,927
"CO19780",42,42,15860,5802,143,215,3890,1912
"CO19785",18,18,5460,1722,37,31,1418,304
"CO19807",63,63,24676,9104,119,191,5047,4057
"CO19809",46,46,14326,6255,29,64,5885,370
"CO19821",41,41,16666,7706,349,165,6535,1171
"CO19824",30,30,10804,3499,47,57,2615,884
"CO19845",31,31,13241,5609,41,206,3913,1696
"CO20001",630,630,279165,86631,379,898,44788,41843
"CO20011",160,160,65630,26568,138,430,8179,18389
"CO20013",99,99,45542,12942,106,163,6261,6681
"CO20032",33,33,14110,3797,36,40,2004,1793
"CO20045",34,34,14502,4540,44,58,2753,1787
"CO20060",64,64,26471,8572,100,109,4979,3593
"CO20175",65,65,23597,6161,30,95,3327,2834
"CO20178",50,50,20688,6516,85,97,3850,2666
"CO20228",60,60,24745,7238,64,109,4286,2952
"CO20238",51,51,22065,5822,35,77,3761,2061
"CO20250",47,47,19849,6365,29,68,4073,2292
"CO20295",27,27,10255,3386,26,26,1609,1777
"CO20310",15,15,3867,1168,25,44,608,560
"CO20383",29,29,10450,3657,31,54,1881,1776
"CO20400",59,59,24815,9417,58,219,5096,4321
"CO20443",20,20,7225,3119,22,46,1913,1206
"CO20517",35,35,14163,4817,57,149,2874,1943
"CO20550",32,32,13460,4632,56,106,2222,2410
"CO20570",41,41,16511,2491,30,37,1706,785
"CO20614",39,39,14285,4300,172,63,1605,2695
"CO20621",44,44,18777,6111,22,65,3528,2583
"CO20710",45,45,18215,6596,39,99,2496,4100
"CO20750",36,36,14089,4887,42,75,3003,1884
"CO20770",37,37,14366,5557,30,111,1934,3623
"CO20787",27,27,10017,2751,27,60,1859,892
"CO27001",197,197,80380,27419,308,795,20260,7159
"CO27006",24,24,8345,2053,33,19,1568,485
"CO27025",47,47,9515,3176,22,19,2942,234
"CO27050",23,23,8224,2584,31,60,2080,504
"CO27073",25,25,8376,2460,12,46,2264,196
"CO27075",21,21,7582,2306,24,20,1917,389
"CO27077",33,33,10197,2974,43,21,2741,233
"CO27099",26,26,6868,2065,6,15,1978,87
"CO27135",14,14,4495,1223,22,36,916,307
"CO27150",16,16,5537,1348,12,8,1290,58
"CO27160",13,13,4109,1620,2,87,1238,382
"CO27205",33,33,10526,3159,45,140,2296,863
"CO27245",16,16,5918,1832,25,46,1033,799
"CO27250",22,22,7257,2643,156,12,2508,135
"CO27361",56,56,21319,5669,88,155,3990,1679
"CO27372",13,13,3049,724,13,7,580,144
"CO27413",21,21,7605,2563,40,63,2128,435
"CO27425",19,19,5663,2238,6,8,2145,93
"CO27430",26,26,7639,2748,16,23,2561,187
"CO27450",24,24,7475,2991,36,54,2580,411
"CO27491",19,19,5232,1635,30,74,1212,423
"CO27495",16,16,5413,1519,12,12,1416,103
"CO27580",13,13,3839,1300,13,27,1185,115
"CO27600",19,19,6144,2543,15,34,1965,578
"CO27615",46,46,13524,3807,36,36,3462,345
"CO27660",21,21,4157,1032,22,47,724,308
"CO27745",8,8,2467,706,17,26,618,88
"CO27787",35,35,12777,4068,56,157,2830,1238
"CO27800",22,22,8348,2162,26,16,1426,736
"CO27810",15,15,5046,1785,26,41,1404,381
"CO23001",685,685,302825,92057,427,781,44207,47850
"CO23068",99,99,39340,9774,102,124,6376,3398
"CO23079",46,46,17581,5589,46,61,4048,1541
"CO23090",42,42,16098,3417,31,20,2640,777
"CO23162",160,160,71178,22925,104,256,11746,11179
"CO23168",32,32,12752,3916,27,27,2825,1091
"CO23182",96,96,35501,12779,273,174,6434,6345
"CO23189",96,96,42082,14881,142,188,9377,5504
"CO23300",36,36,13988,4023,30,59,2636,1387
"CO23350",30,30,12522,3754,100,65,2537,1217
"CO23417",205,205,84539,25945,167,266,17559,8386
"CO23419",35,35,13721,4752,50,39,3695,1057
"CO23464",30,30,12929,4170,25,25,2830,1340
"CO23466",122,122,55017,18274,155,340,10631,7643
"CO23500",46,46,18119,5320,51,65,4230,1090
"CO23555",117,117,53300,14920,128,246,8676,6244
"CO23570",64,64,23411,7310,85,92,4882,2428
"CO23574",49,49,17941,5170,229,60,4000,1170
"CO23580",66,66,25885,10130,113,179,7691,2439
"CO23586",32,32,13416,3750,116,38,1972,1778
"CO23660",192,192,78125,26263,277,284,16501,9762
"CO23670",122,122,48915,18199,429,331,12906,5293
"CO23672",52,52,20685,6957,35,88,4352,2605
"CO23675",65,65,26348,7233,61,57,5799,1434
"CO23678",48,48,19707,3661,25,36,2150,1511
"CO23686",88,88,35301,10964,60,141,7363,3601
"CO23807",140,140,60877,18031,323,311,12579,5452
"CO23855",63,63,25119,6670,90,91,4581,2089
"CO25001",22,22,9742,3840,25,38,1723,2117
"CO25019",12,12,5069,1779,8,33,693,1086
"CO25035",27,27,11225,4474,17,40,2008,2466
"CO25040",27,27,11234,4159,36,46,1698,2461
"CO25053",20,20,8852,3845,26,45,1496,2349
"CO25086",6,6,1987,646,9,6,321,325
"CO25095",8,8,2823,850,13,8,454,396
"CO25099",14,14,5893,3116,16,76,1241,1875
"CO25120",9,9,3457,1337,19,79,991,346
"CO25123",21,21,8749,3442,22,41,1686,1756
"CO25126",89,89,38304,19738,49,275,9016,10722
"CO25148",28,28,10164,3246,57,74,1170,2076
"CO25151",33,33,14339,5394,22,109,2001,3393
"CO25154",16,16,6176,2067,12,41,780,1287
"CO25168",9,9,3664,1461,23,19,740,721
"CO25175",175,175,83132,43432,84,424,21717,21715
"CO25178",17,17,7434,2877,8,43,892,1985
"CO25181",26,26,11254,4615,28,70,1573,3042
"CO25183",34,34,14326,5619,45,110,2041,3578
"CO25200",30,30,12927,6619,19,128,2684,3935
"CO25214",54,54,22995,9973,25,98,4585,5388
"CO25224",12,12,4708,2099,13,49,728,1371
"CO25245",44,44,19138,7124,46,82,3186,3938
"CO25258",12,12,4351,1330,29,17,521,809
"CO25260",31,31,13750,7697,41,171,2479,5218
"CO25269",194,194,87088,45817,109,1056,18839,26978
"CO25279",22,22,9437,3903,25,38,1126,2777
"CO25281",13,13,5483,2003,8,11,438,1565
"CO25286",133,133,60731,30550,56,534,13403,17147
"CO25288",10,10,3913,1601,12,33,773,828
"CO25290",219,219,96948,41213,155,573,17890,23323
"CO25293",14,14,5230,1529,21,43,736,793
"CO25295",21,21,9080,4534,44,113,1718,2816
"CO25297",22,22,9217,3106,32,55,1070,2036
"CO25299",8,8,3103,1149,24,18,540,609
"CO25307",183,183,81967,33222,83,334,12251,20971
"CO25312",13,13,5571,2193,15,39,1022,1171
"CO25317",21,21,8587,3427,36,103,1424,2003
"CO25320",56,56,22188,8242,79,181,3388,4854
"CO25322",24,24,10241,4391,21,60,1555,2836
"CO25324",5,5,2205,709,10,13,402,307
"CO25326",12,12,4945,2090,14,32,811,1279
"CO25328",9,9,3606,1520,9,28,750,770
"CO25335",11,11,4467,1983,9,36,513,1470
"CO25339",7,7,2691,1311,5,27,480,831
"CO25368",7,7,2700,865,16,7,474,391
"CO25372",15,15,5524,1717,13,39,694,1023
"CO25377",47,47,20312,9152,26,114,4885,4267
"CO25386",56,56,23470,8647,36,123,4356,4291
"CO25394",21,21,8708,2802,71,74,1714,1088
"CO25398",13,13,5608,2012,41,30,514,1498
"CO25402",29,29,12184,5271,17,111,2408,2863
"CO25407",16,16,6966,2543,16,77,1011,1532
"CO25426",14,14,6109,1770,20,35,762,1008
"CO25430",118,118,54897,27959,95,641,10555,17404
"CO25436",10,10,4110,1688,17,34,848,840
"CO25438",20,20,6771,2941,39,54,1042,1899
"CO25473",133,133,57821,29568,86,448,13047,16521
"CO25483",6,6,2535,741,3,4,353,388
"CO25486",21,21,8960,4361,35,90,1603,2758
"CO25488",16,16,6256,2504,9,18,1397,1107
"CO25489",9,9,3153,1290,12,24,540,750
"CO25491",12,12,5169,2138,13,40,1252,886
"CO25506",9,9,3562,1190,8,15,677,513
"CO25513",47,47,20502,7685,76,143,3726,3959
"CO25518",13,13,4564,1458,19,22,766,692
"CO25524",10,10,4122,1379,9,23,741,638
"CO25530",19,19,6946,2976,21,69,1227,1749
"CO25535",18,18,7605,2743,20,64,1567,1176
"CO25572",31,31,12932,4273,28,94,1421,2852
"CO25580",8,8,2856,903,11,24,437,466
"CO25592",11,11,3996,1617,13,21,480,1137
"CO25594",13,13,5408,2292,7,53,741,1551
"CO25596",16,16,6135,2047,22,26,745,1302
"CO25599",16,16,6824,2638,16,35,1323,1315
"CO25612",24,24,10455,3764,14,17,1688,2076
"CO25645",21,21,8637,3311,16,33,1704,1607
"CO25649",18,18,7804,2695,18,52,1286,1409
"CO25653",12,12,4319,1342,13,9,651,691
"CO25658",20,20,8389,3279,10,32,1180,2099
"CO25662",21,21,8973,3376,34,41,1523,1853
"CO25718",20,20,8594,3267,18,35,1137,2130
"CO25736",18,18,7764,3754,17,109,1488,2266
"CO25740",56,56,24060,10354,45,179,4132,6222
"CO25743",39,39,16551,6368,44,68,3045,3323
"CO25745",21,21,8608,3276,26,65,1179,2097
"CO25754",457,457,201745,89216,289,1464,42449,46767
"CO25758",37,37,16285,9079,27,137,4579,4500
"CO25769",27,27,11191,5908,21,90,1838,4070
"CO25772",23,23,9730,4576,24,138,1956,2620
"CO25777",10,10,4154,1516,19,30,574,942
"CO25779",12,12,5102,1997,21,76,1048,949
"CO25781",10,10,3746,1559,21,35,563,996
"CO25785",34,34,14659,7232,20,134,3249,3983
"CO25793",14,14,5720,2623,19,63,737,1886
"CO25797",15,15,6197,2266,19,23,1238,1028
"CO25799",33,33,14029,6871,20,93,2903,3968
"CO25805",10,10,3706,1459,29,20,778,681
"CO25807",7,7,3018,1024,31,9,667,357
"CO25815",30,30,12896,4600,20,60,2351,2249
"CO25817",57,57,24441,11836,43,320,4971,6865
"CO25823",11,11,4060,1481,27,38,825,656
"CO25839",23,23,8478,2623,35,69,1082,1541
"CO25841",13,13,5660,2112,25,45,915,1197
"CO25843",72,72,30807,12907,66,274,4922,7985
"CO25845",16,16,6307,2902,15,37,1296,1606
"CO25851",11,11,4700,1800,19,18,616,1184
"CO25862",20,20,7346,2231,45,41,1147,1084
"CO25867",9,9,3867,1399,14,28,726,673
"CO25871",5,5,1915,573,17,17,198,375
"CO25873",29,29,12800,5700,41,89,1661,4039
"CO25875",55,55,21862,9007,49,93,3165,5842
"CO25878",25,25,10358,3905,22,66,1899,2006
"CO25885",31,31,11457,3111,65,51,1339,1772
"CO25898",10,10,4091,2033,16,17,962,1071
"CO25899",184,184,82209,42028,120,807,20348,21680
"CO94001",47,47,19789,5099,45,50,2663,2436
"CO94343",7,7,1986,365,2,5,298,67
"CO94663",1,2,579,49,0,0,45,4
"CO94883",2,2,835,144,5,5,85,59
"CO94884",4,4,1207,105,1,0,60,45
"CO94885",0,1,175,0,0,0,0,0
"CO94886",1,1,338,24,0,1,17,7
"CO94887",3,3,328,162,0,0,116,46
"CO94888",1,1,179,42,1,0,42,0
"CO95001",88,88,37463,15112,189,413,7157,7955
"CO95015",13,13,5482,1496,17,24,1079,417
"CO95025",24,24,9285,3458,47,125,2048,1410
"CO95200",11,11,4217,990,12,11,848,142
"CO41001",576,576,255422,107749,479,1066,49083,58666
"CO41006",43,43,18437,6090,45,79,1432,4658
"CO41013",16,16,6804,2724,26,29,875,1849
"CO41016",36,36,14967,5408,58,71,2491,2917
"CO41020",34,34,14338,5067,75,92,2761,2306
"CO41026",7,7,2991,1000,5,11,439,561
"CO41078",16,16,5983,2263,27,17,1206,1057
"CO41132",58,58,24718,9945,63,173,3811,6134
"CO41206",18,18,6752,2383,33,26,952,1431
"CO41244",8,8,3169,1327,14,14,645,682
"CO41298",115,115,51641,18457,158,287,6356,12101
"CO41306",45,45,18633,6931,65,188,2668,4263
"CO41319",29,29,12391,4463,35,83,1331,3132
"CO41349",13,13,5571,2255,16,42,1005,1250
"CO41357",18,18,6862,2837,24,40,1110,1727
"CO41359",42,42,18179,7467,101,155,2041,5426
"CO41378",24,24,9990,2894,46,69,1291,1603
"CO41396",90,90,40433,13666,114,205,4475,9191
"CO41483",11,11,4497,1728,22,20,604,1124
"CO41503",18,18,7370,3093,36,45,847,2246
"CO41518",11,11,4738,2126,22,27,604,1522
"CO41524",50,50,20533,7715,37,79,2901,4814
"CO41530",20,20,8509,3022,34,64,1146,1876
"CO41548",22,22,9123,3581,22,55,1016,2565
"CO41551",200,200,89760,30656,179,405,10660,19996
"CO41615",38,38,16199,6365,40,90,2919,3446
"CO41660",22,22,8635,3356,38,53,1420,1936
"CO41668",56,56,23344,8393,93,144,2741,5652
"CO41676",19,19,7921,3257,26,47,939,2318
"CO41770",29,29,11911,3210,41,56,1027,2183
"CO41791",29,29,11492,4442,31,59,1427,3015
"CO41797",19,19,7879,3347,24,60,788,2559
"CO41799",27,27,10814,4019,37,83,1899,2120
"CO41801",16,16,6481,2537,11,36,738,1799
"CO41807",36,36,15078,5912,64,65,1441,4471
"CO41872",17,17,6524,2566,22,44,1480,1086
"CO41885",17,17,6750,2939,5,39,1137,1802
"CO44001",262,262,111639,27705,287,298,17613,10092
"CO44078",59,59,23913,6368,13,73,4562,1806
"CO44090",50,50,20549,4615,49,68,3306,1309
"CO44098",23,23,8243,2479,12,31,1587,892
"CO44110",16,16,6765,2480,9,21,1644,836
"CO44279",62,62,25836,8865,40,101,6402,2463
"CO44378",33,33,14034,4150,31,59,2846,1304
"CO44420",10,10,3839,1181,0,15,861,320
"CO44430",270,270,120312,20329,257,187,10766,9563
"CO44560",124,124,52567,3186,30,44,1768,1418
"CO44650",87,87,31264,9168,66,158,4484,4684
"CO44847",283,283,118050,7359,106,108,4046,3313
"CO44855",19,19,7997,3183,10,32,2042,1141
"CO44874",41,41,18149,5915,50,79,3490,2425
"CO47001",724,724,322962,92960,461,767,49797,43163
"CO47030",23,23,9422,1992,21,28,1525,467
"CO47053",64,64,26547,1517,8,25,962,555
"CO47058",51,51,21723,5504,79,51,3393,2111
"CO47161",22,22,8394,2409,11,23,2184,225
"CO47170",33,33,13108,3555,25,39,2827,728
"CO47189",187,187,81617,17299,388,117,8629,8670
"CO47205",25,25,10564,2592,15,16,2251,341
"CO47245",109,109,46365,12275,141,152,6883,5392
"CO47258",34,34,13197,3035,32,22,2506,529
"CO47268",30,30,12752,2732,144,27,1932,800
"CO47288",112,112,51126,8917,35,97,4609,4308
"CO47318",62,62,22148,4632,47,36,2989,1643
"CO47460",34,34,14283,2975,20,18,1770,1205
"CO47541",24,24,8926,1892,20,14,1340,552
"CO47545",23,23,7813,2459,22,24,1557,902
"CO47551",69,69,28335,7246,48,84,6313,933
"CO47555",96,96,39220,9615,92,98,6312,3303
"CO47570",49,49,20274,3877,108,37,1957,1920
"CO47605",19,19,7037,1916,12,15,1716,200
"CO47660",28,28,10380,1818,33,17,1090,728
"CO47675",18,18,7454,1295,8,10,738,557
"CO47692",43,43,15820,5021,32,41,3903,1118
"CO47703",21,21,7946,2795,21,14,2298,497
"CO47707",37,37,15232,4214,27,37,2301,1913
"CO47720",22,22,7978,2120,15,21,1737,383
"CO47745",42,42,17808,2413,88,19,1649,764
"CO47798",28,28,9842,2907,28,39,2469,438
"CO47960",20,20,7739,2608,19,21,2119,489
"CO47980",103,103,42952,3575,22,25,2307,1268
"CO50001",786,786,343296,157463,400,1757,56633,100830
"CO50006",131,131,56070,29491,130,663,7978,21513
"CO50110",12,12,4287,1717,11,34,613,1104
"CO50124",12,12,4569,1900,13,30,718,1182
"CO50150",26,26,10531,6089,36,149,1739,4350
"CO50223",12,12,4902,1987,15,30,602,1385
"CO50226",41,41,15494,7555,31,115,2456,5099
"CO50245",7,7,1707,664,11,11,354,310
"CO50251",14,14,5374,2021,31,34,1247,774
"CO50270",9,9,2794,1347,11,13,570,777
"CO50287",24,24,9442,3709,31,75,1556,2153
"CO50313",110,110,48638,19422,125,421,7007,12415
"CO50318",25,25,10375,5394,15,62,1316,4078
"CO50325",17,17,5394,1202,12,33,697,505
"CO50330",19,19,7585,2969,30,46,1843,1126
"CO50350",20,20,7900,3038,19,51,2238,800
"CO50370",12,12,4724,2176,24,14,2036,140
"CO50400",20,20,7903,2923,39,92,1287,1636
"CO50450",15,15,5998,2172,31,61,1198,974
"CO50568",55,55,22483,8450,254,188,2813,5637
"CO50573",55,55,22839,9182,47,126,2564,6618
"CO50577",17,17,6338,2248,24,41,997,1251
"CO50590",20,20,7957,2996,23,79,1443,1553
"CO50606",34,34,14935,6021,23,60,2464,3557
"CO50680",19,19,7764,3573,22,59,1179,2394
"CO50683",17,17,5998,2226,18,48,1064,1162
"CO50686",6,6,1263,572,6,8,309,263
"CO50689",44,44,17621,7755,47,99,2162,5593
"CO50711",30,30,12070,4903,74,126,2593,2310
"CO52001",648,648,279784,112335,501,1505,70354,41981
"CO52019",16,16,6438,2854,65,65,1244,1610
"CO52022",14,14,5756,2566,38,52,1298,1268
"CO52036",22,22,7235,2314,32,35,1683,631
"CO52051",15,15,5703,2390,54,67,1154,1236
"CO52079",65,65,20859,4222,76,63,3159,1063
"CO52083",14,14,5328,2352,35,32,1418,934
"CO52110",42,42,16930,5835,85,109,2921,2914
"CO52203",19,19,6620,2607,73,127,1573,1034
"CO52207",28,28,8497,3403,55,83,1969,1434
"CO52210",16,16,5544,1939,23,25,1036,903
"CO52215",27,27,10104,3439,72,53,2138,1301
"CO52224",17,17,7169,2627,43,37,1245,1382
"CO52227",55,55,23407,8506,131,216,5421,3085
"CO52233",19,19,6203,2418,19,25,2119,299
"CO52240",26,26,9510,3804,43,50,2377,1427
"CO52250",42,42,15747,5064,97,60,4599,465
"CO52254",15,15,5357,2866,33,58,2312,554
"CO52256",20,20,6649,2582,19,42,2344,238
"CO52258",28,28,10814,4537,84,109,2980,1557
"CO52260",28,28,11253,5039,99,108,3563,1476
"CO52287",17,17,5549,2312,38,31,1575,737
"CO52317",33,33,14068,4449,54,78,2511,1938
"CO52320",30,30,10811,3055,51,47,2255,800
"CO52323",13,13,5077,2336,15,32,1404,932
"CO52352",17,17,6900,2287,37,45,1430,857
"CO52354",20,20,6314,2068,33,28,1156,912
"CO52356",204,204,92217,31706,617,503,15864,15842
"CO52378",36,36,13571,5498,105,87,2846,2652
"CO52381",24,24,8949,3140,48,39,2292,848
"CO52385",9,9,3376,1396,36,58,996,400
"CO52390",14,14,4996,1944,8,23,1710,234
"CO52399",60,60,21535,7447,125,164,3200,4247
"CO52405",22,22,7254,2882,47,44,2605,277
"CO52411",24,24,8485,3499,69,64,3047,452
"CO52418",20,20,7132,3149,70,60,2426,723
"CO52427",24,24,6221,2286,24,34,2129,157
"CO52435",19,19,5984,1829,30,38,1154,675
"CO52473",21,21,5897,2199,13,22,1975,224
"CO52480",10,10,4120,1637,15,21,988,649
"CO52490",37,37,13572,3204,34,36,2632,572
"CO52506",17,17,5668,1739,38,26,1102,637
"CO52520",21,21,6308,1579,15,27,1332,247
"CO52540",27,27,9537,4151,55,51,3690,461
"CO52560",26,26,9425,3399,48,63,1590,1809
"CO52565",10,10,4259,1814,50,26,1586,228
"CO52573",19,19,7410,3188,34,70,2191,997
"CO52585",34,34,14600,5830,63,140,2820,3010
"CO52612",41,41,13557,2921,79,48,1947,974
"CO52621",29,29,8368,2333,10,22,2135,198
"CO52678",65,65,22140,8431,69,166,7072,1359
"CO52683",40,40,15906,6554,107,112,4208,2346
"CO52685",15,15,6072,3064,57,50,1892,1172
"CO52687",32,32,12768,4523,98,158,2812,1711
"CO52693",31,31,11317,3574,92,93,2353,1221
"CO52694",14,14,5234,2047,49,52,1058,989
"CO52696",22,22,6997,2435,12,24,2229,206
"CO52699",21,21,6875,1814,54,39,1301,513
"CO52720",15,15,5628,1804,21,32,1089,715
"CO52786",34,34,13578,4820,100,94,3792,1028
"CO52788",26,26,9879,3126,26,46,1659,1467
"CO52835",400,400,121788,33054,503,709,23534,9520
"CO52838",86,86,34090,9905,147,268,6384,3521
"CO52885",20,20,8133,3203,61,88,2169,1034
"CO54001",1236,1236,542712,241314,1325,3088,83572,157742
"CO54003",60,60,21133,6244,56,77,2095,4149
"CO54051",20,20,6826,2985,53,58,907,2078
"CO54099",17,17,6046,2866,25,50,1080,1786
"CO54109",12,12,4108,1398,30,70,413,985
"CO54125",6,6,2156,845,4,24,413,432
"CO54128",24,24,6959,2591,15,28,531,2060
"CO54172",27,27,11426,5334,29,90,1983,3351
"CO54174",21,21,7562,2785,45,78,1056,1729
"CO54206",40,40,14827,3512,83,137,2101,1411
"CO54223",16,16,6168,2788,79,72,938,1850
"CO54239",12,12,4279,1888,13,32,1003,885
"CO54245",36,36,10030,2903,38,118,1515,1388
"CO54250",29,29,11167,3089,41,92,2827,262
"CO54261",48,48,20243,7794,67,181,2770,5024
"CO54313",13,13,4850,1885,23,38,632,1253
"CO54344",20,20,6906,1746,34,59,1562,184
"CO54347",9,9,3574,1146,18,28,377,769
"CO54377",13,13,4905,1659,18,32,877,782
"CO54385",25,25,8292,2962,43,55,1021,1941
"CO54398",17,17,6626,1503,32,39,734,769
"CO54405",175,175,78165,28480,58,293,7986,20494
"CO54418",8,8,3214,1221,25,53,317,904
"CO54480",7,7,2664,1104,9,21,499,605
"CO54498",175,175,76057,27473,126,378,10753,16720
"CO54518",89,89,43064,18585,85,293,6506,12079
"CO54520",9,9,3796,1755,41,46,577,1178
"CO54553",30,30,13119,2198,10,28,591,1607
"CO54599",16,16,6440,1688,17,23,422,1266
"CO54660",22,22,7487,3003,47,106,974,2029
"CO54670",25,25,6979,2514,25,68,2393,121
"CO54673",17,17,6918,2203,8,33,694,1509
"CO54680",9,9,3311,1421,8,30,642,779
"CO54720",55,55,17063,5716,78,119,1991,3725
"CO54743",11,11,3968,1359,15,18,259,1100
"CO54800",28,28,9725,2809,45,99,2429,380
"CO54810",77,77,31208,8855,99,228,5847,3008
"CO54820",33,33,12026,4114,61,135,1311,2803
"CO54871",9,9,3727,1217,21,23,297,920
"CO54874",170,170,79404,26486,78,275,6360,20126
"CO86001",87,87,35245,12823,84,159,7718,5105
"CO86219",10,10,4244,1876,17,19,1072,804
"CO86320",63,63,25937,7985,86,155,6165,1820
"CO86568",102,102,41742,10806,145,207,6267,4539
"CO86569",23,23,8922,2749,50,79,1947,802
"CO86571",29,29,10561,3008,41,57,2176,832
"CO86573",36,36,14436,3726,29,39,2031,1695
"CO86749",24,24,10309,4282,75,77,2499,1783
"CO86755",11,11,4710,1918,35,45,1069,849
"CO86757",28,28,11779,3375,56,56,2816,559
"CO86760",14,14,5929,2240,32,48,1359,881
"CO86865",56,56,23170,7734,78,105,6655,1079
"CO86885",39,39,15777,5626,54,114,2869,2757
"CO63001",568,568,247873,102884,913,1205,43835,59049
"CO63111",7,7,2857,1005,6,17,441,564
"CO63130",136,136,58297,23324,262,377,8767,14557
"CO63190",57,57,21943,9180,53,131,3343,5837
"CO63212",12,12,5090,1900,25,35,872,1028
"CO63272",27,27,10343,4149,39,68,1522,2627
"CO63302",18,18,7384,2726,29,55,987,1739
"CO63401",65,65,27501,10854,98,204,4032,6822
"CO63470",77,77,33103,11538,108,227,3398,8140
"CO63548",17,17,6022,2338,13,34,815,1523
"CO63594",68,68,29792,11684,211,154,4528,7156
"CO63690",16,16,5762,2519,27,32,853,1666
"CO66001",891,891,393135,162661,836,2278,75063,87598
"CO66045",25,25,10487,3669,47,84,1265,2404
"CO66075",15,15,5565,1965,23,44,891,1074
"CO66088",52,52,21462,6917,73,143,2639,4278
"CO66170",354,354,154003,66050,364,1044,28055,37995
"CO66318",26,26,10351,3683,45,67,1240,2443
"CO66383",15,15,6500,2365,33,59,903,1462
"CO66400",68,68,31403,12081,120,210,4852,7229
"CO66440",39,39,15561,5417,88,97,2067,3350
"CO66456",27,27,11096,3642,58,65,1926,1716
"CO66572",23,23,9245,2728,76,47,1720,1008
"CO66594",47,47,19821,7878,184,259,4144,3734
"CO66682",127,127,59393,24796,184,518,9970,14826
"CO66687",31,31,12258,3586,70,119,1473,2113
"CO88001",108,108,47881,9588,52,36,5275,4313
"CO68001",1154,1154,495063,223128,457,1982,100143,122985
"CO68013",4,4,1524,347,8,6,165,182
"CO68020",10,10,3290,1164,21,15,656,508
"CO68051",15,15,6477,2579,50,51,1328,1251
"CO68077",58,58,24199,8965,64,162,4413,4552
"CO68079",15,15,6261,2537,20,51,1452,1085
"CO68081",399,399,167609,75700,402,1153,38260,37440
"CO68092",11,11,3989,1453,11,39,620,833
"CO68101",28,28,8280,2671,76,98,1400,1271
"CO68121",4,4,1644,678,7,10,446,232
"CO68132",4,4,1676,684,5,19,152,532
"CO68147",11,11,4870,1775,33,32,672,1103
"CO68152",15,15,3656,1567,23,61,509,1058
"CO68160",10,10,1771,902,16,25,584,318
"CO68162",11,11,4803,2058,37,82,949,1109
"CO68167",22,22,9583,3501,28,53,2148,1353
"CO68169",11,11,3218,1313,8,18,372,941
"CO68176",6,6,2338,857,25,31,558,299
"CO68179",10,10,4142,960,17,12,687,273
"CO68190",73,73,28154,9198,79,271,3718,5480
"CO68207",15,15,4893,1657,165,62,642,1015
"CO68209",6,6,2348,845,6,14,321,524
"CO68211",8,8,2920,1316,25,30,762,554
"CO68217",11,11,4141,1486,41,67,795,691
"CO68229",24,24,8217,3267,35,76,1526,1741
"CO68235",31,31,10715,4252,44,162,1138,3114
"CO68245",5,5,1590,773,17,23,539,234
"CO68250",14,14,3339,1251,32,45,620,631
"CO68255",34,34,11556,4198,59,104,1157,3041
"CO68264",5,5,2123,649,17,26,405,244
"CO68266",13,13,3267,1297,18,30,595,702
"CO68271",15,15,5159,1665,16,22,1115,550
"CO68276",423,423,178805,86829,167,870,36189,50640
"CO68296",12,12,2536,1037,14,31,434,603
"CO68298",9,9,3239,1100,16,19,603,497
"CO68307",251,251,105643,45151,114,549,17099,28052
"CO68318",19,19,5140,1981,33,38,766,1215
"CO68320",12,12,4334,1515,22,30,607,908
"CO68322",5,5,1834,738,9,27,381,357
"CO68324",11,11,4470,1303,14,28,808,495
"CO68327",10,10,4173,1433,9,20,885,548
"CO68344",5,5,1825,774,24,19,464,310
"CO68368",9,9,3248,1020,16,19,645,375
"CO68370",4,4,1107,385,11,3,194,191
"CO68377",14,14,5353,2205,17,28,741,1464
"CO68385",26,26,9356,2820,62,173,1484,1336
"CO68397",12,12,4139,1171,17,29,681,490
"CO68406",76,76,29381,12595,61,175,3857,8738
"CO68418",21,21,8529,3908,35,166,1643,2265
"CO68425",6,6,2244,803,16,21,456,347
"CO68432",41,41,15663,6624,39,178,2538,4086
"CO68444",14,14,4853,2200,17,39,866,1334
"CO68464",21,21,7512,2666,60,128,1165,1501
"CO68468",15,15,3592,1361,34,38,531,830
"CO68498",9,9,3773,1618,17,35,1129,489
"CO68500",20,20,8450,3474,29,79,1543,1931
"CO68502",12,12,3795,1188,47,41,634,554
"CO68522",4,4,1353,580,8,6,397,183
"CO68524",6,6,2453,982,11,20,526,456
"CO68533",9,9,3201,1545,8,33,791,754
"CO68547",242,242,100462,47962,340,739,19145,28817
"CO68549",8,8,3181,1319,13,25,742,577
"CO68572",37,37,12869,4349,35,72,2492,1857
"CO68573",14,14,5414,1513,15,17,487,1026
"CO68575",62,62,22860,8415,42,162,4098,4317
"CO68615",63,63,22075,8022,95,179,2675,5347
"CO68655",47,47,20581,7733,59,124,2386,5347
"CO68669",24,24,7084,2954,52,79,1642,1312
"CO68673",7,7,2989,863,9,8,584,279
"CO68679",101,101,40079,16990,215,257,8574,8416
"CO68682",5,5,2219,693,21,25,429,264
"CO68684",13,13,3917,1765,28,25,578,1187
"CO68686",9,9,2161,779,22,24,423,356
"CO68689",63,63,24555,8841,80,252,3604,5237
"CO68705",6,6,1995,708,11,15,255,453
"CO68720",9,9,3101,1029,19,65,396,633
"CO68745",16,16,5898,2207,17,66,1237,970
"CO68755",56,56,23774,9397,36,123,4348,5049
"CO68770",20,20,8256,2584,29,65,1395,1189
"CO68773",20,20,5837,1802,28,28,698,1104
"CO68780",10,10,3016,1283,20,40,478,805
"CO68820",13,13,4950,1957,16,66,808,1149
"CO68855",12,12,4637,1839,18,45,935,904
"CO68861",42,42,16435,5996,37,160,3254,2742
"CO68867",4,4,1466,568,2,10,92,476
"CO68872",15,15,6336,2339,16,34,912,1427
"CO68895",18,18,7366,2547,22,51,984,1563
"CO70001",446,446,195898,68896,722,771,37461,31435
"CO70110",22,22,9619,3180,48,22,2187,993
"CO70124",25,25,8757,2749,41,24,2126,623
"CO70204",17,17,6755,2321,27,26,1628,693
"CO70215",107,107,45886,17880,120,206,10907,6973
"CO70221",27,27,10921,3833,24,41,1918,1915
"CO70230",11,11,4403,1335,40,19,869,466
"CO70233",24,24,7694,2871,19,22,2238,633
"CO70235",39,39,15770,5220,61,51,2181,3039
"CO70265",33,33,12792,3512,24,48,1811,1701
"CO70400",25,25,9408,2928,37,18,2329,599
"CO70418",43,43,17591,7530,65,66,5779,1751
"CO70429",73,73,26077,6792,85,52,3935,2857
"CO70473",33,33,12813,5075,46,101,3322,1753
"CO70508",51,51,20135,7347,65,58,5328,2019
"CO70523",26,26,9642,3334,31,29,2323,1011
"CO70670",78,78,30974,11412,126,170,6816,4596
"CO70678",53,53,18505,5377,62,46,3460,1917
"CO70702",27,27,11225,4467,28,39,3185,1282
"CO70708",103,103,42745,11094,122,165,7058,4036
"CO70713",105,105,40959,10220,117,121,7973,2247
"CO70717",38,38,16284,5795,62,38,3759,2036
"CO70742",63,63,25579,8963,82,112,5470,3493
"CO70771",65,65,20688,5559,59,52,3100,2459
"CO70820",54,54,22816,7727,54,89,5427,2300
"CO70823",45,45,17811,7287,74,63,5227,2060
"CO73001",889,889,392554,179659,656,2184,70780,108879
"CO73024",12,12,3725,1457,14,46,452,1005
"CO73026",22,22,8422,2727,24,36,1312,1415
"CO73030",19,19,6922,2342,14,47,1216,1126
"CO73043",19,19,7462,2269,51,42,693,1576
"CO73055",25,25,10172,3470,30,68,1794,1676
"CO73067",42,42,14957,5109,75,68,1658,3451
"CO73124",38,38,16190,5907,54,85,1823,4084
"CO73148",20,20,8453,3460,12,34,1218,2242
"CO73152",13,13,4940,1875,29,22,922,953
"CO73168",83,83,38101,12170,174,172,5476,6694
"CO73200",21,21,7709,2645,22,34,1488,1157
"CO73217",41,41,17192,5485,119,81,3404,2081
"CO73226",19,19,7208,2591,26,31,1075,1516
"CO73236",19,19,6729,2672,35,52,1109,1563
"CO73268",134,134,58148,23011,111,324,8388,14623
"CO73270",14,14,5702,2142,36,52,1147,995
"CO73275",39,39,17194,6567,38,88,2373,4194
"CO73283",68,68,26101,8283,100,183,2741,5542
"CO73319",63,63,25766,8825,75,114,3042,5783
"CO73347",17,17,5922,1852,40,40,724,1128
"CO73349",49,49,23027,8337,62,150,3549,4788
"CO73352",22,22,8395,2833,30,49,1498,1335
"CO73408",38,38,15269,5560,28,77,2748,2812
"CO73411",72,72,32895,10396,145,226,5158,5238
"CO73443",68,68,28817,10847,80,217,4570,6277
"CO73449",65,65,27553,10765,47,130,3102,7663
"CO73461",10,10,3782,1099,14,56,409,690
"CO73483",38,38,15411,5301,41,78,2970,2331
"CO73504",63,63,23729,8119,159,227,3247,4872
"CO73520",17,17,7468,2415,24,49,1003,1412
"CO73547",14,14,5387,1933,10,25,974,959
"CO73555",47,47,19662,5899,108,198,2818,3081
"CO73563",21,21,7933,2920,36,43,1121,1799
"CO73585",49,49,20186,8184,50,105,4045,4139
"CO73616",41,41,16033,4526,133,119,2209,2317
"CO73622",11,11,4175,1496,22,48,768,728
"CO73624",52,52,19506,6063,57,152,1776,4287
"CO73671",29,29,12416,4417,22,53,1463,2954
"CO73675",25,25,10013,3867,83,94,1097,2770
"CO73678",28,28,10802,4233,54,57,1638,2595
"CO73686",16,16,5802,1741,19,31,485,1256
"CO73770",11,11,4386,1795,3,15,700,1095
"CO73854",14,14,4942,1462,12,26,673,789
"CO73861",29,29,11721,4407,29,52,1929,2478
"CO73870",22,22,7181,2337,43,39,605,1732
"CO73873",15,15,5204,1741,10,42,671,1070
"CO76001",3617,3617,1637938,589451,2298,4496,319949,269502
"CO76020",27,27,11192,3690,41,69,1804,1886
"CO76036",47,47,19548,6724,40,101,3505,3219
"CO76041",53,53,19269,5276,49,80,1667,3609
"CO76054",19,19,6426,1906,19,30,923,983
"CO76100",38,38,13389,4824,65,75,2065,2759
"CO76109",517,517,219150,60235,629,1525,42565,17670
"CO76111",236,236,100078,41528,202,551,20956,20572
"CO76113",50,50,19020,6911,54,136,3977,2934
"CO76122",72,72,28321,9992,143,186,3886,6106
"CO76126",42,42,13908,4587,41,77,2238,2349
"CO76130",154,154,68548,23423,136,440,10898,12525
"CO76147",262,262,111785,38946,222,554,14845,24101
"CO76233",96,96,35005,10524,80,150,4666,5858
"CO76243",30,30,8127,2820,20,56,871,1949
"CO76246",21,21,6723,1851,52,32,932,919
"CO76248",118,118,51868,18112,101,263,9380,8732
"CO76250",30,30,9808,2959,32,51,972,1987
"CO76275",124,124,50135,18260,219,347,10354,7906
"CO76306",43,43,16309,6445,75,99,3182,3263
"CO76318",68,68,27420,10341,61,184,5786,4555
"CO76364",222,222,96350,33725,161,518,18060,15665
"CO76377",32,32,12758,4059,29,44,2037,2022
"CO76400",66,66,26489,10178,81,170,2792,7386
"CO76403",30,30,11609,4164,41,55,1930,2234
"CO76497",30,30,11185,3549,27,81,1579,1970
"CO76520",619,619,261731,99709,509,1162,54278,45431
"CO76563",102,102,39766,14837,120,258,7574,7263
"CO76606",40,40,14911,4351,38,58,1777,2574
"CO76616",42,42,15859,5168,44,98,2103,3065
"CO76622",78,78,28313,11003,56,115,4631,6372
"CO76670",41,41,14680,5397,34,75,2708,2689
"CO76736",95,95,37835,12820,157,335,6589,6231
"CO76823",36,36,12667,3805,44,77,1383,2422
"CO76828",45,45,15793,5256,60,85,1960,3296
"CO76834",366,366,157134,60615,436,1001,27738,32877
"CO76845",14,14,4636,1621,25,28,909,712
"CO76863",28,28,7989,2613,35,38,963,1650
"CO76869",27,27,10404,3366,36,35,1812,1554
"CO76890",39,39,14310,4966,33,61,2358,2608
"CO76892",223,223,96839,34347,171,470,18095,16252
"CO76895",89,89,36664,13212,67,263,6632,6580
"CO97001",39,39,15576,3577,20,30,2705,872
"CO97161",5,5,1721,458,0,7,382,76
"CO97511",4,4,1080,186,1,3,170,16
"CO97666",4,4,1377,308,36,1,243,65
"CO97777",1,1,109,19,0,0,18,1
"CO97889",4,4,1035,315,1,0,278,37
"CO99001",44,44,17433,4734,24,62,2185,2549
"CO99524",19,19,7267,2448,23,33,661,1787
"CO99624",7,7,3013,1265,6,13,576,689
"CO99773",52,52,19420,3669,42,52,2717,952
